内気	(adj-na,n,adj-no) bashfulness; shyness; reserve; timidity; (P).	内気[うちき]	<br />▲彼女は内気な性格の持ち主です。 She shows a shy disposition.<br />▲一言で言うなら、彼女の問題は内気なことだ。 Off hand, I'd say her problem is shyness.<br />▲その美しい少女はその内気な青年にさよならを言うと思う。 I guess that the beautiful girl will say goodbye to the shy young man.
柔和	(adj-na,n) gentleness; mildness; meekness; (P).	柔和[にゅうわ]	<br />▲柔和な答は怒りをしりぞける。 A soft answer turneth away wrath.<br />▲そのひとは態度が柔和であった。 The man was mild of manner.
興味をそそる	(exp,v5r) to arouse someone's interest; to whet (appetite); to be appealing; to be intriguing; to be fascinating.	興味をそそる[きょうみをそそる]	
ふと	(ateji) (adv) (uk) suddenly; casually; accidentally; incidentally; unexpectedly; unintentionally.	ふと[ふと]	
成熟	(n,vs,adj-no) maturity; ripeness; (P).	成熟[せいじゅく]	<br />▲私たちは独特で成熟したひとりひとりの人間になるべきだ。 We should become unique, mature individuals.<br />▲彼女は素敵な女性に成熟していた。 She had matured into an excellent woman.<br />▲このオレンジはすぐに成熟します。 These oranges mature fast.
人柄	(adj-na,n) personality; character; personal appearance; gentility; (P).	人柄[ひとがら]	<br />▲今の彼女の人柄は１０年前の彼女の人柄ではない。 She is not what she used to be ten years ago.<br />▲私は人柄で人を判断するように心がけている。 I make a point of judging a man by his personality.<br />▲人の価値は財産よりもむしろ人柄にある。 A man's worth lies in what he is rather than in what he has.
仏心	(n) mercy; merciful heart; charity.	仏心[ほとけごころ]	
現実逃避	(n,adj-no) escape from reality; escapism; ostrichism.	現実逃避[げんじつとうひ]	
せめぎ合う	(v5u) to fight each other.	せめぎ合う[せめぎあう]	
身を翻す	(exp,v5s) to turn aside adroitly; to dodge.	身を翻す[みをひるがえす]	
気が利く	(exp,v5k) <br />① to be sensible; to be smart; to be tasteful.<br />② to be thoughtful; to be tactful; to be sensitive.	気が利く[きがきく]	<br />▲あいつは気が利く。 He is smart.<br />▲気が利くなあ。 You've got a good head on your shoulders.<br />▲ワインを冷やしておいてくれたとは気が利いてるね。 How thoughtful of you to have chilled some wine for us.
痛感	(n,vs) feeling keenly; fully realizing; (P).	痛感[つうかん]	<br />▲私は教育の重要性を痛感した。 It was brought home to me how important education is.<br />▲あの事故を見て自然の力を痛感した。 That accident brought home to me the power of nature.<br />▲最近になってようやく人々は自然保護の必要性を痛感するようになってきた。 It is only recently that people have begun to realize the importance of nature conservation.
ぶっ放す	(v5s) to fire a gun; to let off a gun; to loose off a shell.	ぶっ放す[ぶっぱなす]	
取り扱う	(v5u,vt) to treat; to handle; to deal in; (P).	取り扱う[とりあつかう]	<br />▲科学者は主として物質の問題を取り扱う。 Scientists deal mainly with physical matters.<br />▲統計学は事実を表す数を取り扱うものである。 Statistics deals with collected numbers representing facts.<br />▲彼女は子供のように取り扱われることには我慢ならない。 She can't stand being treated like a child.
均一化	(n,vs) homogenization; homogenisation.	均一化[きんいつか]	
媒介	(n,vs) intermediary; (P).	媒介[ばいかい]	<br />▲マラリアは蚊が媒介する。 Malaria is carried by mosquitoes.
助け舟	(n) lifeboat; friend in need; timely help.	助け舟[たすけぶね]	<br />▲私が質問に答えられないでいると、彼が助け舟を出してくれた。 When I didn't know how to answer the question, he gave me a hint.
単位	(n) <br />① unit; denomination.<br />② credit (in school); (P).	単位[たんい]	<br />▲土地はエーカー単位で売っています。 They sell land by the acre.<br />▲この服地は１ヤード単位で売られている。 This cloth is sold by the yard.<br />▲この表の数値は千単位で示されている。 The figures in this table are shown in thousands.
単位	(n) <br />① unit; denomination.<br />② credit (in school); (P).	単位[たんい]	<br />▲ダース単位で卵を買う。 We buy eggs by the dozen.<br />▲ポンドは重さの単位である。 A pound is a unit of weight.<br />▲私たちが生まれるとすぐに、世界は私たちに影響を与え始め、私たちを単なる生物学的単位から社会的単位へ変える。 As soon as we are born, the world gets to work on us and transforms us from merely biological into social units.
途方もない	(adj-i) extraordinary; preposterous; outrageous; absurd.	途方もない[とほうもない]	<br />▲そんな途方もない話は聞いたことがない。 That's the damnedest story I ever heard.<br />▲唯一、人生に意味を与えてくれるような芸術作品の中に美しい人生と言うものも含めて考える事によって、私は後にこの途方もない考えを修正したのだが、それでも私が尊重していたのはやはり美であった。 Although I modified this extravagance later by including the beautiful life among the works of art that alone gave a meaning to life, it was still beauty that I valued.<br />▲月旅行なんてかつては途方もないことと考えられた。 Flights to the moon were once thought absurd.
媒介	(n,vs) intermediary; (P).	媒介[ばいかい]	<br />▲マラリアは蚊が媒介する。 Malaria is carried by mosquitoes.
透過	(adj-na,n,vs) penetration; permeation; transmission.	透過[とうか]	
固有	(adj-no,adj-na) characteristic; traditional; peculiar; inherent; native; eigen-; (P).	固有[こゆう]	<br />▲日本は北方領土を日本固有のものにしたがっている。 Japan claims the Northern Territories for its own.<br />▲生存本能はあらゆる生物に固有のものである。 The instinct for survival is inherent in every living thing.<br />▲それは日本固有の習慣だ。 That is a custom proper to Japan.
伝播	(ik) (n,vs) transmission; propagation; spread; circulation; diffusion; dissemination.	伝播[でんぱん]	
分泌	(n,vs,adj-no) secretion; (P).	分泌[ぶんぴ]	<br />▲女性ホルモン分泌の乱れが不妊症の大きな原因です。 Female hormone imbalance is a major cause of infertility.
神経伝達物質	(n) neurotransmitter.	神経伝達物質[しんけいでんたつぶっしつ]	
範疇	(n) category.	範疇[はんちゅう]	<br />▲しかしながら、人間はなぜこれらの範疇に入ってしまうのか。 Why people fall into these categories, however, is a mystery.<br />▲あなたは充分可愛い女の子の範疇に入ると思います。部長のおめがねには余裕でかなってしまうでしょう。 I think you fall well within 'cute girl'. You'd easily go and pass in his judgement.<br />▲彼らはその範疇に属さない。 They don't belong under that category.
密談	(n,vs) private or confidential or secret talk.	密談[みつだん]	
筒抜け	(n) <br />① being overheard; being leaked (e.g. secrets).<br />② going in one ear and out the other.	筒抜け[つつぬけ]	
想起	(n) <br />① remembering; recollection; recall; retrieval; (vs) <br />② to remember; to recall; to recollect; to call to mind; to envision.	想起[そうき]	
雛形	(n) <br />① model; miniature; pattern.<br />② sample; specimen.<br />③ prescribed form.	雛形[ひながた]	
こじつけ	(n,adj-no) distortion; stretch; strained interpretation; technicality; casuistry; sophistry.	こじつけ[こじつけ]	<br />▲何か、全部、こじつけって感じがするんだけど・・・。 Somehow, all those reasons sound rather far fetched.
研ぎ澄ます	(v5s,vt) to sharpen; to grind; to whet; to hone; to make keen.	研ぎ澄ます[とぎすます]	<br />▲ここにいるといやでも感覚は研ぎ澄まされる。 I can't help but feel that when I come here, all my senses are sharper than usual.
苦手意識	(n) awareness that somebody (something) is (will be) hard to deal with; awareness that one is not good at something.	苦手意識[にがていしき]	
弁明	(n,vs,adj-no) explanation; excuse; vindication; apology; (P).	弁明[べんめい]	<br />▲長期の欠席について彼に弁明を求めた。 We called him to account for his long absence.<br />▲私は君の行いについて弁明を聞きたい。 I shall want an explanation of your behavior.<br />▲君は自分の不始末をどう弁明するのか。 What account can you give of your misbehavior?
怪訝	(adj-na) dubious; puzzled; suspicious.	怪訝[けげん]	
ちょいと	(adv) <br />① (uk) just a minute; short time; just a little.<br />② somewhat; easily; readily; rather.<br />③ (will not) easily; (int) <br />④ hey!.	ちょいと[ちょいと]	
お手本	(n) example; role model.	お手本[おてほん]	
抽象	(adj-na,n,adj-no) abstract; (P).	抽象[ちゅうしょう]	
ほんわか	(adv,adv-to) (on-mim) warm; snug; comfortable.	ほんわか[ほんわか]	
塩梅	(n,vs) <br />① seasoning; flavour; flavor.<br />② condition; state; situation.<br />③ arrangement; assignment; adjustment; (P).	塩梅[あんばい]	<br />▲いい塩梅だ。 The seasoning is just right.<br />▲塩梅はいかがですか。 How do you feel?
熟練者	(n) expert (in, at); skilled hand; man of experience.	熟練者[じゅくれんしゃ]	
羅列	(n,vs) enumeration; citation; listing; (P).	羅列[られつ]	<br />▲彼の日記は出来事の羅列に近かった。もっとも時には、長々と記述することもあった。 His diary was a kind of list of events, though he commented at length once in a while.
至近距離	(n,adj-no) point-blank range.	至近距離[しきんきょり]	
うん蓄	(n,vs) great erudition; extensive knowledge; one's vast stock of knowledge.	うん蓄[うんちく]	
虫の知らせ	(exp,n) foreboding.	虫の知らせ[むしのしらせ]	
瀕する	(vs-s) to be on the verge of; to be about to; to be on the point of.	瀕する[ひんする]	<br />▲１９３９年には、１９１４年と同様、世界は戦争の危機に瀕していた。 In 1939, as in 1914, the world was on the brink of war.<br />▲その病人の生命は危険にひんしている。 The sick man's life is in danger.<br />▲この鳥は絶滅の危機に瀕している。 This bird is in danger of dying out.
恨めしい	(adj-i) reproachful; hateful; bitter.	恨めしい[うらめしい]	
真髄	(n,adj-no) true meaning; mystery; essence; quintessence; soul; core; kernel; life blood; (P).	真髄[しんずい]	
微細	(adj-na,n) minute; micro; detailed; delicate; subtle; (P).	微細[びさい]	<br />▲キャンバスのオイルはとても微細な花びらを描けない。 Oil on canvas can never paint a petal so delicate.
口走る	(v5r,vt) to speak; to tell; to blurt out; (P).	口走る[くちばしる]	
危険視	(n,vs) regarded as dangerous.	危険視[きけんし]	
迫害	(n,vs) persecution; (P).	迫害[はくがい]	<br />▲彼は人々を宗教により迫害しました。 He persecuted people for their religion.<br />▲初期の宗教指導者の中には敵対する人々に迫害されたものもいる。 Some early religion's leaders were persecuted by their enemies.<br />▲ローマ人はキリスト教徒を迫害した。 The Romans persecuted Christians.
吹き込む	(v5m,vi,vt) <br />① to blow into; to breathe into; (v5m,vt) <br />② to inspire; to indoctrinate.<br />③ to record (music, video, etc.); (P).	吹き込む[ふきこむ]	<br />▲壊れた窓から冷たい風が吹き込んで寒かった。 Cold blasts from the broken window chilled us.<br />▲忠告を与えることは出来るが、行動を起こさせる霊感を吹き込むことは出来ない。 We may give advice, but we do not inspire conduct.<br />▲彼は許してくれは私に自信を吹き込んでくれた。 He inspired me with confidence.
追いやる	(v5r,vt) <br />① to drive away; to order off; to chase away.<br />② to force into an unpleasant situation (bankruptcy, prostitution, suicide, etc.).	追いやる[おいやる]	<br />▲これ以上の値引きは、私どもを赤字に追いやるでしょう。 A further reduction would make us go into the red.<br />▲彼は試験の失敗によって絶望に追いやられた。 His failure in the examination drove him to despair.<br />▲彼は失業に追いやられた。 He was forced into unemployment.
役得	(n) emoluments; perquisite; side benefit.	役得[やくとく]	
乖離	(n,vs) divergence; alienation; deviation; estrangement; separation; detachment.	乖離[かいり]	
恒例	(n) established practice; custom; (P).	恒例[こうれい]	
超絶的	(adj-na) transcendental.	超絶的[ちょうぜつてき]	
身につく	(exp,v5k) <br />① to master (e.g. a skill); to become accustomed to (e.g. a lifestyle); to acquire (e.g. a habit).<br />② to retain.	身につく[みにつく]	
無駄骨	(n) useless; waste of time and effort; pointless; vain efforts.	無駄骨[むだぼね]	
探究心	(n) spirit of inquiry; spirit of enquiry.	探究心[たんきゅうしん]	
食いしん坊	(n,adj-na,adj-no) glutton; gourmand.	食いしん坊[くいしんぼ]	
よそ見	(n,vs) looking away; looking aside; (P).	よそ見[よそみ]	
配属	(n,vs) assignment (of a person to somewhere); attachment (of a person to another unit, organization, etc.); (P).	配属[はいぞく]	<br />▲営業マンだって、リストラ予備軍に配属されないように必死な訳です。 After all, even salesmen are desperate to avoid being targeted for downsizing.
男勝り	(adj-na,n,adj-no) (of a woman) strong-minded; spirited; mannish.	男勝り[おとこまさり]	<br />▲彼は男まさりの姉に育てられた。 He was bought up by his strong willed sister.
幾重にも	(adv) repeatedly; over and over again.	幾重にも[いくえにも]	
轍を踏む	(exp,v5m) to repeat a mistake (of somebody); to make the same mistake as that of ...; to follow the rut (left by someone else).	轍を踏む[てつをふむ]	
気が滅入る	(exp,v5r) to feel depressed; to be down.	気が滅入る[きがめいる]	<br />▲心配で気がめいっている。 I've been worrying myself into depression.<br />▲今日は少し気がめいっている。 I'm feeling a little blue today.<br />▲雨の日は気がめいるよ。 Rainy days make me depressed.
奨励	(n,vs) encouragement; promotion; inducement; incitement; stimulation; (P).	奨励[しょうれい]	<br />▲江戸時代に、各藩の奨励策によって、全国各地に地場産業が興った。 Local industry flourished throughout the land in the Edo period thanks to the promotional efforts by each clan.<br />▲人々はフットボールをするように奨励さえされたのです。 People were even encouraged to play football.<br />▲私たちの学校ではスポーツを奨励している。 Our school encourages sports.
取り越し苦労	(n) overanxiety; needless worry.	取り越し苦労[とりこしぐろう]	<br />▲君はいつも取り越し苦労をしている。 You're always anticipating trouble.<br />▲取り越し苦労はするな。 If the sky falls we shall catch larks.<br />▲取り越し苦労をするな。 Don't cross the bridge till you come to it.
蠢動	(n,vs) <br />① wriggling; squirming; maneuvering; manoeuvering.<br />② mischief; despicable acts.	蠢動[しゅんどう]	
人だかり	(n,vs) crowd; throng; (P).	人だかり[ひとだかり]	<br />▲話し手の周りには人だかりがしていた。 A crowd of people gathered around the speaker.
偲ぶ	(v5b,vt) to recollect; to remember; to reminisce; to be nostalgic for.	偲ぶ[しのぶ]	<br />▲故人をしのんで、記念碑が建てられた。 A monument was erected in memory of the deceased.<br />▲ミサは、食べたり飲んだりしてイエスキリストを偲ぶカトリックの儀式だ。 Mass is a Catholic ceremony of remembering Jesus Christ by eating and drinking.
僭越	(adj-na) presumptuous; arrogant; audacious; forward; insolent.	僭越[せんえつ]	
見繕う	(v5u,vt) to choose (a thing) at one's own discretion; to use one's discretion in choosing.	見繕う[みつくろう]	
三昧	(n) <br />① samadhi (state of intense concentration achieved through meditation) (san:); (n-suf) <br />② concentrating on something; absorbing oneself in something.	三昧[さんまい]	
近いうちに	(adv) before long.	近いうちに[ちかいうちに]	<br />▲近いうちにお便りいただけるのをたのしみにしています。 I am looking forward to hearing from you soon.<br />▲近いうちにこちらから連絡します。 You'll be hearing from us soon.<br />▲近いうちにお会いしたい。 I hope to see you soon.
忌むべき	(exp) abominable; detestable.	忌むべき[いむべき]	
おっかない	(adj-i) <br />① (col) (ktb:) frightening; scary.<br />② (col) (ktb:) extreme; exaggerated; huge.	おっかない[おっかない]	
排斥	(n,vs) rejection; expulsion; boycott; ostracism; (P).	排斥[はいせき]	<br />▲その国では日本製品を排斥する運動が起こっていた。 There is a movement against Japanese goods in that country.
良かれと思う	(exp,v5u) to wish to go well; to have good intentions.	良かれと思う[よかれとおもう]	
動悸	(n) palpitation (e.g. heart); pulsation; throbbing.	動悸[どうき]	<br />▲動悸が激しくなることがよくあります。 I often experience palpitations of the heart.
間を置いて	(exp) intermittently; at intervals (of); after a pause.	間を置いて[まをおいて]	
正否	(n) right and wrong.	正否[せいひ]	
揉める	(v1,vi) to disagree; to dispute; (P).	揉める[もめる]	<br />▲彼らは財産分けのことでもめている。 They are arguing about their share of the property.<br />▲その子供たちはいつも親ともめる。 Those children always get into trouble with their parents.<br />▲今、温泉に行くかスキーに行くかもめているんだよ。 We're torn between going to a hot spring and going skiing.
気が引ける	(v1,exp) to feel awkward; to feel shy.	気が引ける[きがひける]	<br />▲彼をパーティーに招待しなかったのは気が引ける。 I didn't invite him to the party. I feel guilty about it.<br />▲こんな身なりで外出するのは気が引ける。 I am ashamed to go out, dressed like this.<br />▲彼女にそれを言うのは気が引ける。 I don't feel like telling her about it.
接ぎ穂	(n) <br />① scion; cion; (horticultural) graft.<br />② opportunity to continue a conversation.	接ぎ穂[つぎほ]	<br />▲果樹栽培者がリンゴの接ぎ穂を台木に接ぎ木しました。 The orchardist grafted an apple bud onto the rootstock.<br />▲話の接ぎ穂がなくて困った。 He found it very hard to keep the conversation going.
話の腰を折る	(exp,v5r) to interfere; to butt in; to interrupt someone.	話の腰を折る[はなしのこしをおる]	
こじつけ	(n,adj-no) distortion; stretch; strained interpretation; technicality; casuistry; sophistry.	こじつけ[こじつけ]	<br />▲何か、全部、こじつけって感じがするんだけど・・・。 Somehow, all those reasons sound rather far fetched.
極地	(n,adj-no) farthest land; furthest land; polar regions.	極地[きょくち]	<br />▲雪の上にも、極地の氷の上にも、そして熱帯雨林のも住んでいる。 They live on the snow and ice of the Poles and in tropical jungles.<br />▲オーロラは極地に特有の現象です。 The aurora is a phenomenon characteristic of the Polar Regions.<br />▲北極熊は極地の氷原に住んでいるのだが、生息地を失い、絶滅するであろう。 The polar bear, which lives on the polar ice-cap, will lose its home and die out.
ばつの悪い	(adj-i) awkward; uncomfortable; embarrassing.	ばつの悪い[ばつのわるい]	
むず痒い	(adj-i) <br />① itchy.<br />② creepy; feeling uneasy.	むず痒い[むずがゆい]	
どことなく	(adv) (uk) somehow; for some reason; vaguely.	どことなく[どことなく]	
陰る	(v5r,vi) to darken; to get dark; to be clouded; to be obscured.	陰る[かげる]	
薄暮	(n) dusk; nightfall; twilight.	薄暮[はくぼ]	<br />▲いよいよ薄暮、もうすぐ宵闇。 It's getting more and more shadowy, soon it will be twilight.
思慮	(n,vs) prudence.	思慮[しりょ]	<br />▲彼の思慮の無さには驚いた。 He was amazed at his foolishness.<br />▲彼の忠告はいつでも大変思慮分別がある。 His advice is always very sensible.<br />▲彼女はとても思慮深く、しんぼうづよい。 She is very thoughtful and patient.
よじ登る	(v5r,vi) to climb; to clamber (over, up); to scramble (up); to scale; to claw one's way up.	よじ登る[よじのぼる]	<br />▲私は鳩たちがその箱の上によじ登ったご褒美に餌を与えた。 I rewarded my pigeons with food for climbing onto the box.<br />▲彼は猿のように木によじ登った。 He climbed up the tree like a monkey.<br />▲私は鳩たちがその箱の上によじ登った褒美に餌を与えた。 I rewarded my pigeons with food for climbing onto the box.
不覚を取る	(exp,v5r) to suffer an embarrassing defeat.	不覚を取る[ふかくをとる]	
明晰	(adj-na) clear; distinct.	明晰[めいせき]	
自責の念	(exp) guilty conscience; feelings of remorse.	自責の念[じせきのねん]	
げんなり	(adv,vs) wearily; dejectedly.	げんなり[げんなり]	
単身	(n-adv,n-t) alone; unaided; away from home; (P).	単身[たんしん]	
頭を振る	(exp,v5r) to shake one's head (in denial).	頭を振る[かぶりをふる]	
急遽	(adj-na,adv) hurriedly; in a hurry; (P).	急遽[きゅうきょ]	
どことなく	(adv) (uk) somehow; for some reason; vaguely.	どことなく[どことなく]	
上の空	(adj-na,n) inattention; absent-mindedness.	上の空[うわのそら]	<br />▲君はいつもうわの空だ。 You are always hearing but not listening.<br />▲頭上の空は濃い水色だった。 The sky above was a deep blue.<br />▲私は彼の言うことを上の空で聞いていた。 While he was talking, I guess I was absent-minded.
どよめき	(n) (uk) commotion; stir.	どよめき[どよめき]	
起こりうる	(exp) to be possible to occur.	起こりうる[おこりうる]	<br />▲夢の世界ではどんなことでも起こりうる。 Anything can happen in the world of dreams.<br />▲事故は起こりうるものだ。 Accidents will happen.<br />▲他の文化について十分な知識を持っていなければ、色々な問題が容易に起こりうる。 If we don't obtain an adequate knowledge of their culture, a lot of problems could easily arise.
鼻白む	(v5m,vi) to feel let down; to feel ashamed.	鼻白む[はなしろむ]	
八つ当たり	(n,vs) outburst of anger; venting one's anger; (P).	八つ当たり[やつあたり]	<br />▲オレに八つ当たりするなよ。 Don't take it out on me.<br />▲彼はいつも人にやつあたりをします。 He really has it out for people.
辿々しい	(adj-i) (uk) with difficulty; faltering; tottering; awkward.	辿々しい[たどたどしい]	<br />▲老人がたどたどしい足取りで歩いてきた。 An old man came tottering along.
変貌	(n,vs) transfiguration; transformation; change of appearance; (P).	変貌[へんぼう]	<br />▲日本は工業化の結果急激な変貌を遂げた。 Japan has undergone a drastic change as a result of industrialization.
代償	(n,adj-no) compensation; indemnification; reparation; consideration; (P).	代償[だいしょう]	<br />▲彼女は親切の代償として何も受け取らなかった。 She got nothing in reward for her kindness.<br />▲こういう特典に対して私達はどんな代償を支払わなければならないのか。 What price do we have to pay for these advantages?<br />▲平和を勝ち取るために、これからどれだけの代償を払わなければならぬか、予想もつかぬ。 How much we still have to pay for peace is a riddle.
思いやる	(v5r) to be considerate; to sympathize with; to sympathise with; (P).	思いやる[おもいやる]	<br />▲他人を思いやる気持ちが大切です。 It's important for us to be thoughtful of others.<br />▲いつも自分以外の人の気持ちを思いやらなくてはならない。 We must always consider the feelings of others.
似たりよったり	(adj-na,n) much the same.	似たりよったり[にたりよったり]	
減退	(n,vs) decline; ebb; failure; decay; decrease; loss; (P).	減退[げんたい]	<br />▲景気の減退が始まると、短期契約社員達は次々に一時解雇を言い渡された。 As the recession set in, temporary employees were laid off one after another.<br />▲食欲が急に減退するのは病気の兆候である事がある。 Sudden decrease in appetite is sometimes a sign of illness.
詰め所	(n) station; office; guardroom.	詰め所[つめしょ]	
気に障る	(exp,v5r) to hurt one's feelings; to rub someone the wrong way.	気に障る[きにさわる]	<br />▲タバコはお気にさわりますか。 Would you mind if I smoked?<br />▲彼が言ったことのいくつかが私の気に障ったんだ。 Some of the things he said got under my skin.<br />▲何か気に障るようなことを言いましたか。 Have I said something to hurt your feelings?
やぼ用	(n) minor business.	やぼ用[やぼよう]	
怪文書	(n) objectionable literature.	怪文書[かいぶんしょ]	
